
C 135,206,235
F 245,222,172

NO north.xpm
WE west.xpm
EA east.xpm
SO south.xpm



1111
1E01
1111

